********************
********************
*****S**************
********S***S*******
****************S***
****E*S****S********
D***S**************D
*********P**********
*************S***S**
*****E*********E****
******S*************
*************S******
********************
********************